1111111111
1P0CE1
1011111111
1111111111